XXXXXX
XXXXXX
XHXXXX
X*FX X
XXFX X
XFFFFX
XXXXXX